START 0 0 EXIT 9 9
0000101010
1110100010
0100111000
0000100111
1011101000
1000101110
1011100001
1010101101
1000001001
1111111100