START 0 0 EXIT 59 59
000001000000010000000001000100000000010001010000000000000101
111101111101010111111111010101111101010101010111010111110101
000100000101010000010000010000000101000101010100010100010001
011111110101010111010111111111110101111101010101110101011111
000000000101010001000000010001000100010000010100010101000001
011111111101011101111111110101111101011111110111011101111101
000000000101000101000000010100000101010000010001000001000101
111111110101110101011111010111110111010111011101111111011101
000000010001000101010000010100010001000100000101000000010001
111101111111011101011111010101011101011101111101011111010111
000001000100010001010001000101000001010100010000010000010001
011111010101111101010101111101111111010111010111111111111101
000000010100000101010101000001000100010001010101000100000001
011111110111110111010101110111010101110101010101010101111101
000100000000010001000100010100010100010101010101010001000101
110101111111011101111111010101110111010111010101011111110101
000101000101000100010000010001000100010001010001000000010101
111101010101110111010111111111011111011101011101111111010101
000001010001000101010000000101010001000101000101000100010101
011111011111011101010111110101010101110101110101110101110101
010001000100000001010100010101000101010000010101000101000101
011101010101111111010101110101111101011111010101011101011101
000101010001000000010001000100000101000000010001010001000101
110101011111011111111101011101011101011111111101010111110101
000101000001010000010101010001010001010001000100010100000101
011101110111011101010101010111010111110101010111110101011101
010000010100010001010001010101000100000100010000000101010001
011101110101110111011111010101111101111111111111111111010111
000100000100000100010000010000000001000000000101000001010001
010101111111111101110111111111111111011111110101010101011101
010101000000000001000001000000000001010000010100010100010001
010101011111111111110101111101111101011101010111010101110111
010101000001000000010101000001000101000101010001010101000101
110101111101010111010101011111011101110101011101110101011101
000100000101010100010101010000000100000101000101000101010001
011111110101110101111101011101110111111101110101011101010101
000100000100000100000101000100010001000001010001010001010101
010111111111111111110101010111011101011111011111010111010111
010001000000000000010101010001000101000100000000010100010001
011101011111111111010101110101110101110101111101110101111101
010001010000000001010100010100010100000101000101000100010001
110101010111111101010111011111010111111111010101011111010111
000101010100010001010000010000010100010000010001010000010001
011111010101010111011111110111110101010111111111010111111101
010000010101000000000100000100010001010100000000010100000001
010111110111111111110111110101011111010111111111110101011101
010000010000010001000100000101000001010100000000000101000101
011101111111010101011101111101010111010101111111111111110101
000001000100010101000001000001010100000101000001000000010101
011111010101110101111111011111011101111101110101010111010101
000001010001000101000100010001000100010001000101010101010101
111111010111011101010111010101110111010111011101110101010111
000000010100010100010001000100010000010100010100000101010001
011111110101110111111101111101111111010101110111111101010101
000100000101000100000001010001000001010001000001000100010101
110101111101110101111111010111011101111111110101010101111101
000100010001000100000001000100010101000000000100010100000101
011111110111010111111101111101110101011111011111111111110101
000000000000010000000100000000000100000001000000000000000000
111111111111111111111111111111111111111111111111111111111100